贈り物	おく,り,もの,
点	てん,
皆さん	みな,さ,ん,
速い	はや,い,
特急;は;速い	とっ,きゅう,は,はや,い,
残念な	ざん,ねん,な,
覚える	おぼ,え,る,
漢字;を;覚える	かん,じ,を,おぼ,え,る,
働く	はたら,く,
練習する	れん,しゅう,す,る,
歌;を;練習する	うた,を,れん,しゅう,す,る,
連絡する	れん,らく,す,る,
予定;を;連絡する	よ,てい,を,れん,らく,す,る,
場合	ば,あい,
病気;の;場合	びょう,き,の,ば,あい,
地震;の;場合	じ,しん,の,ば,あい,
遅い	おそ,い,
普通電車;は;遅い	ふ,つう,でん,しゃ,は,おそ,い,
用意する	よう,い,す,る,
急に	きゅう,に,
