切符	きっ,ぷ,
電車;の;切符	でん,しゃ,の,きっ,ぷ,
切符;を;買う	きっ,ぷ,を,か,う,
枚	まい,
シャツ;を;二枚;買う	シ,ャ,ツ,を,に,まい,か,う,
コピー;が;一枚;足りない	コ,ピ,ー,が,いち,まい,た,り,な,い,
暑い	あつ,い,
暑い;国	あつ,い,くに,
寒い	さむ,い,
寒い;日	さむ,い,ひ,
暖かい	あたた,か,い,
暖かい所	あたた,か,い,ところ,
涼しい	すず,し,い,
涼しい風	すず,し,い,かぜ,
咲く	さ,く,
花;が;咲く	はな,が,さ,く,
払う	はら,う,
電話代;を;払う	でん,わ,だい,を,はら,う,
増える	ふ,え,る,
人;が;増える	ひと,が,ふ,え,る,
迎える	むか,え,る,
友達;を;迎えに行く	とも,だち,を,むか,え,に,い,く,
変な	へん,な,
変な味	へん,な,あじ,
熱;が;上がる	ねつ,が,あ,が,る,
円;が;下がる	えん,が,さ,が,る,
落ちる	お,ち,る,
箱;が;落ちる	はこ,が,お,ち,る,