下ろす	お,ろ,す,
降ろす	お,ろ,す,
届ける	とど,け,る,
世話をする	せ,わ,を,す,る,
嫌な	いや,な,
厳しい	きび,し,い,
塾	じゅく,
スケジュール	ス,ケ,ジ,ュ,ー,ル,
生徒	せい,と,
者	もの,
入館	にゅう,かん,
再入国ビザ	さい,にゅう,こく,ビ,ザ,
自由に	じ,ゆう,に,
いいことですね。	い,い,こ,と,で,す,ね,。,
お忙しいですか。	お,いそが,し,い,で,す,か,。,
久しぶり	ひさ,し,ぶ,り,
営業	えい,ぎょう,
それまでに	そ,れ,ま,で,に,
かまいません。	か,ま,い,ま,せ,ん,。,
楽しむ	たの,し,む,
もともと	も,と,も,と,
世紀	せい,き,
代わりをする	か,わ,り,を,す,る,
スピード	ス,ピ,ー,ド,
競走する	きょう,そう,す,る,
サーカス	サ,ー,カ,ス,
芸	げい,
美しい	うつく,し,い,
姿	すがた,
心	こころ,
とらえる	と,ら,え,る,
にとって	に,と,っ,て,